3,3,3,3,3,3,3,3,3,3,3,3,3,3,3,3,3,3,3,3,3,3,3,3,3,3,3,3,3,3,3,3,3,3,3,3,3,3,3,3,3,3,3,3,3,3,3,3,3,3,3,3,3,3,3,3,3,3,3,3,3,3,3,3,3,3,3,3,3,3,3,3,3,3,3,3,3,3,3,3,3,3,3,3,3,3,3,3,3,3,3,3,3,3,3,3,3,3,3,3,3,3,3,3,3,3,3,3,3,3,3,3,3,3,3,3,3,3,3,3,3,3,3,3,3,3,3,3,3,3,3,3,3,3,3,3,3,3,3,3,3,3,3,3,3,3,3,3,3,3
3,0,0,0,0,0,0,0,0,0,0,0,0,0,0,0,0,0,0,0,0,0,0,0,0,0,0,0,0,0,0,0,0,0,0,0,0,0,0,0,0,0,0,0,0,0,0,0,0,0,0,0,0,0,0,0,0,0,0,0,0,0,0,0,0,0,0,0,0,0,0,0,0,0,0,0,0,0,0,0,0,0,0,0,0,0,0,0,0,0,0,0,0,0,0,0,0,0,0,0,0,0,0,0,0,0,0,0,0,0,0,0,0,0,0,0,0,0,0,0,0,0,0,0,0,0,0,0,0,0,0,0,0,0,0,0,0,0,0,0,0,0,0,0,0,0,0,0,0,0
3,0,0,0,0,0,0,0,0,0,0,0,0,0,0,0,0,0,0,0,0,0,0,0,0,0,0,0,0,0,0,0,0,0,0,0,0,0,0,0,0,0,0,0,0,0,0,0,0,0,0,0,0,0,0,0,0,0,0,0,0,0,0,0,0,0,0,0,0,0,0,0,0,0,0,0,0,0,0,0,0,0,0,0,0,0,0,0,0,0,0,0,0,0,0,0,0,0,0,0,0,0,0,0,0,0,0,0,0,0,0,0,0,0,0,0,0,0,0,0,0,0,0,0,0,0,0,0,0,0,0,0,0,0,0,0,0,0,0,0,0,0,0,0,0,0,0,0,0,0
3,0,0,2,4,4,4,4,2,2,2,2,4,4,2,2,2,2,2,2,2,2,4,2,2,4,4,4,2,2,2,4,4,4,4,4,2,4,2,4,4,2,2,4,2,4,2,2,4,4,4,4,4,2,4,2,2,2,2,4,4,4,2,4,4,2,4,4,4,2,4,4,4,4,2,4,2,2,4,2,4,4,4,4,4,2,4,4,2,2,4,2,4,2,2,2,2,2,2,2,2,4,4,4,2,4,2,2,4,4,2,4,4,4,2,4,4,2,2,2,2,4,2,2,2,2,4,2,4,4,2,4,4,2,4,4,4,4,4,2,4,4,2,4,2,4,2,1,1,6
3,0,0,4,4,4,2,2,4,4,4,2,2,2,4,2,2,2,2,2,2,2,2,4,4,4,2,2,2,4,2,2,2,2,2,2,2,2,4,2,2,4,2,2,2,2,2,2,4,4,2,2,2,2,2,2,2,4,4,4,4,4,2,4,2,2,2,2,4,4,4,4,2,2,2,4,4,2,2,4,2,2,2,2,2,4,2,4,4,4,2,4,4,2,4,2,4,2,2,2,4,2,4,2,2,4,2,4,2,2,4,4,4,4,2,4,2,2,4,4,2,4,4,4,2,2,2,4,4,4,4,4,2,4,2,4,2,2,4,4,2,2,2,4,2,2,2,1,1,6
3,0,0,4,2,2,2,2,2,4,2,4,2,2,2,4,4,4,2,4,4,4,2,4,4,2,2,2,2,2,4,4,4,4,2,4,4,2,4,4,4,2,2,4,4,4,4,2,2,4,4,2,2,2,4,4,2,4,2,2,4,4,2,4,4,2,2,2,2,2,4,2,2,2,4,2,2,4,4,4,2,4,4,2,4,2,4,4,4,2,4,2,4,2,4,4,4,4,4,2,4,4,4,4,4,4,2,4,4,2,2,4,2,2,4,4,4,4,4,4,4,4,2,2,2,2,4,2,2,4,4,2,2,2,4,4,4,4,2,2,4,2,2,2,4,2,4,1,1,6
3,0,0,2,4,2,2,2,4,2,2,4,4,2,4,2,4,4,2,4,2,2,2,2,2,2,4,2,4,4,2,4,2,2,2,2,2,2,4,4,2,2,2,2,4,2,2,4,2,4,2,4,2,4,2,2,2,2,2,4,4,2,2,4,4,4,4,2,2,2,2,4,4,2,2,4,2,2,2,4,4,2,2,4,2,4,4,2,4,4,4,2,2,2,2,4,4,4,4,2,4,4,4,2,4,2,2,4,2,2,2,2,2,2,4,2,4,2,4,2,2,4,4,4,2,2,2,4,2,4,2,4,4,4,4,4,2,4,4,2,2,2,2,4,4,2,4,1,1,6
3,0,0,4,2,2,2,4,4,4,2,2,4,4,4,4,2,4,2,2,4,2,2,4,2,2,4,2,4,4,2,4,2,2,2,2,2,4,2,2,2,2,2,2,2,4,2,2,4,2,4,4,2,2,4,4,2,2,2,2,2,2,4,2,2,2,2,4,2,4,4,2,2,2,2,4,4,2,2,4,2,2,2,2,4,2,2,4,2,4,2,4,2,4,2,4,2,2,4,2,2,4,2,4,4,4,4,2,2,2,2,4,2,4,4,4,4,2,4,2,4,4,2,4,4,2,2,2,4,2,2,4,2,4,4,4,2,4,2,4,4,2,2,2,2,2,4,1,1,6
3,0,0,4,2,2,4,4,4,4,4,4,4,2,4,2,4,2,4,2,2,4,4,4,4,4,4,4,4,4,4,4,4,2,2,2,4,2,2,4,2,4,4,2,2,4,4,4,2,2,2,2,2,2,2,2,2,2,4,2,4,2,4,4,2,4,4,4,4,4,2,4,4,4,2,2,2,2,4,4,2,4,2,4,4,4,2,2,4,4,4,2,2,4,4,4,2,2,2,2,2,2,4,2,2,4,4,2,2,4,4,4,2,2,2,4,4,4,2,4,4,4,4,2,4,2,2,4,4,4,2,4,2,4,2,4,4,4,2,4,4,4,2,4,4,2,4,1,1,6
3,0,0,2,4,4,4,2,2,4,2,4,4,2,4,4,4,2,4,2,4,2,2,2,2,4,2,2,2,4,2,2,4,2,4,2,2,4,2,4,4,4,2,2,4,4,2,4,2,2,2,4,4,4,4,2,4,4,4,4,2,2,4,4,4,2,4,2,4,2,2,4,4,2,4,4,2,2,2,2,4,2,4,2,2,2,4,2,4,4,4,4,2,2,2,4,4,4,2,4,4,4,2,2,2,2,4,2,4,4,2,2,4,2,4,2,2,4,2,4,4,4,2,4,4,2,2,4,4,2,2,4,4,4,2,2,2,4,2,2,2,4,2,4,4,4,2,1,1,6
3,0,0,4,2,2,2,2,2,4,2,4,2,4,4,2,4,2,4,4,4,4,2,4,2,4,4,2,4,2,4,4,2,2,4,2,2,2,4,2,4,2,4,4,4,2,2,2,2,2,2,2,4,4,4,4,2,4,2,2,2,4,4,2,4,2,2,2,2,4,2,2,4,4,2,4,4,2,2,2,4,2,2,2,4,2,4,2,2,4,2,2,2,2,2,2,4,4,4,2,4,4,2,4,2,2,4,2,2,4,4,2,2,4,2,4,2,4,4,2,2,2,2,2,4,4,4,4,2,4,2,2,4,2,4,2,2,4,2,4,2,4,2,4,4,4,4,1,1,6
3,0,0,2,2,2,4,2,2,2,4,2,4,2,4,2,4,4,2,2,2,2,2,4,2,4,4,4,4,4,2,4,4,2,2,2,2,4,2,2,4,4,2,2,4,2,2,4,2,2,2,4,4,4,4,4,2,2,2,4,2,4,2,4,2,2,2,4,2,2,4,4,2,2,2,2,4,2,4,2,4,4,2,4,2,2,4,2,2,4,4,4,2,4,4,2,2,2,4,4,2,2,4,2,4,2,2,2,4,2,2,2,4,2,4,4,4,2,2,4,4,2,2,2,2,4,4,2,2,2,2,2,2,4,4,4,4,4,4,4,4,4,2,2,2,4,4,1,1,6
3,0,0,4,2,2,2,2,4,2,2,4,4,2,2,2,2,2,4,4,4,2,4,4,4,4,2,4,4,2,4,4,2,4,4,2,4,4,2,2,2,2,2,2,2,4,4,4,2,2,4,4,2,4,2,2,4,4,2,4,4,4,4,2,2,4,2,4,2,4,2,4,2,4,2,4,4,2,4,4,2,4,2,4,2,2,4,2,4,4,2,2,2,2,2,4,2,2,2,4,4,4,2,2,2,4,4,4,2,4,4,2,2,2,2,2,4,2,4,2,4,2,2,4,4,4,2,2,2,2,2,4,4,4,4,2,4,2,2,2,2,4,2,4,2,2,2,1,1,6
3,0,0,2,2,4,2,4,4,2,4,2,4,2,2,2,2,4,4,4,2,2,2,2,2,2,4,2,2,4,2,4,2,2,4,2,4,4,2,4,2,2,4,4,4,2,2,2,2,4,2,4,2,2,2,4,2,2,4,4,2,2,2,4,4,4,4,2,4,4,4,2,2,2,2,2,4,2,4,4,4,2,4,2,4,4,2,2,4,2,4,4,2,4,4,2,2,4,2,4,4,4,4,4,2,4,4,2,4,4,2,4,2,4,4,2,2,4,2,4,4,2,2,4,2,2,4,2,2,4,4,4,2,2,4,2,2,2,4,4,4,4,2,2,4,4,4,1,1,6
3,0,0,4,2,4,4,2,4,2,2,2,4,4,4,4,4,4,2,2,4,2,2,4,4,4,4,4,2,2,4,4,2,2,4,2,2,4,2,4,2,4,4,4,2,4,4,4,2,2,4,2,4,2,2,4,2,4,2,4,2,4,4,4,2,2,2,2,4,4,2,4,4,4,2,2,2,4,2,2,2,4,4,4,4,2,4,2,2,2,2,2,2,2,2,4,4,2,4,2,2,4,4,2,4,4,4,2,2,4,2,4,4,2,2,2,4,4,4,2,4,2,4,4,4,4,2,2,4,2,2,4,4,4,2,2,2,2,2,4,4,4,4,4,4,2,2,1,1,6
3,0,0,4,4,4,2,4,2,2,2,2,2,4,4,4,4,2,2,4,4,4,2,2,4,2,4,4,4,4,2,4,4,4,2,2,2,4,2,2,4,2,2,4,2,4,2,2,4,2,4,4,4,2,4,4,4,2,4,2,2,4,2,2,2,2,4,2,4,2,4,4,2,4,2,4,4,4,2,4,2,4,2,4,4,2,4,4,2,4,4,4,4,2,4,2,4,4,2,4,4,2,4,4,4,4,2,4,4,2,2,4,2,2,2,4,4,2,4,4,2,4,2,2,4,4,2,4,2,4,4,4,2,2,4,4,2,4,2,4,4,4,4,2,4,2,2,1,1,6
3,0,0,4,2,4,4,4,2,4,2,2,2,2,2,2,4,2,4,2,2,2,4,2,4,2,4,2,2,2,2,4,2,2,4,2,2,4,4,2,2,4,2,2,4,4,4,4,2,2,4,4,4,4,2,2,2,4,2,4,2,2,2,4,2,2,4,4,2,2,4,2,2,2,2,2,4,2,2,2,4,2,2,4,2,2,2,2,4,2,2,4,2,2,2,2,2,4,4,4,2,4,4,2,2,2,4,2,4,4,2,4,2,4,2,4,2,4,4,4,2,4,4,2,2,4,2,2,4,2,2,4,4,2,4,4,2,2,2,4,4,2,2,2,4,2,4,1,1,6
3,0,0,2,2,2,4,4,2,2,4,2,2,2,2,4,4,2,2,4,2,4,4,4,4,4,4,2,2,2,4,2,4,4,2,4,4,2,4,2,4,4,4,4,4,4,4,4,2,4,2,4,4,2,2,2,2,2,2,2,4,2,4,2,4,4,4,2,4,4,2,2,4,4,4,4,4,2,2,4,2,4,2,4,4,2,2,4,4,2,2,4,2,2,2,4,4,4,4,4,4,4,4,4,4,4,4,2,4,2,2,2,2,2,4,2,2,2,2,2,2,2,2,2,4,2,2,4,2,2,2,4,2,4,4,2,4,4,2,4,2,4,4,2,4,2,4,1,1,6
3,0,0,2,4,2,2,2,4,4,4,2,2,4,2,4,2,2,2,4,4,4,2,4,2,2,4,2,2,4,4,4,4,4,2,2,2,2,2,2,2,2,2,2,2,2,4,2,2,2,2,2,4,4,4,4,4,2,4,4,4,4,4,2,4,2,4,4,4,4,2,2,4,2,2,2,4,4,4,2,2,4,4,2,4,4,2,2,2,2,4,2,4,2,4,4,4,2,4,2,2,2,2,2,4,4,4,4,4,4,2,4,2,2,4,2,2,4,4,4,4,2,4,4,2,4,2,2,4,4,2,2,4,2,4,2,2,2,4,2,4,2,4,4,4,4,4,1,1,6
3,0,0,4,4,2,2,2,4,4,4,2,4,2,4,4,2,2,2,2,4,2,2,4,4,2,2,2,4,4,2,2,4,4,4,2,2,2,4,4,2,4,2,4,4,4,4,2,4,2,4,4,4,4,4,2,2,2,2,2,4,4,4,2,4,4,4,4,2,2,2,2,4,2,4,4,2,4,4,4,4,2,4,4,4,4,4,4,4,2,4,4,4,4,4,4,2,4,4,4,2,2,2,2,4,2,2,2,2,4,2,2,2,2,4,4,2,4,2,2,2,4,4,2,2,4,4,2,2,4,2,4,2,4,4,2,4,4,2,4,2,2,2,2,4,4,4,1,1,6
3,0,0,2,2,2,2,4,2,2,4,2,4,4,4,2,2,4,2,4,2,4,2,4,2,2,4,2,4,4,2,4,4,2,2,2,2,2,2,2,2,2,4,4,2,4,2,4,2,2,2,2,2,4,2,4,2,2,2,2,4,4,2,2,4,2,2,4,4,4,2,2,4,4,4,2,4,4,2,2,2,4,2,2,2,2,4,4,2,4,4,4,2,4,2,2,2,2,4,2,2,2,4,4,2,4,2,4,2,4,2,4,2,2,4,2,2,4,4,2,4,4,2,2,4,4,2,4,4,4,4,2,2,4,2,2,2,4,4,2,2,2,2,2,2,4,2,1,1,6
3,0,0,4,2,2,4,2,2,4,4,4,2,2,2,2,2,4,2,4,4,2,2,4,2,2,4,4,2,4,2,4,4,2,2,4,4,2,2,4,4,4,2,4,4,2,2,2,2,2,2,2,4,2,4,2,2,2,2,4,4,2,4,4,4,2,4,2,4,2,4,2,4,2,4,2,2,4,4,4,2,2,2,2,4,2,2,2,4,4,2,4,2,4,4,2,4,4,4,2,2,2,2,2,2,4,2,2,2,4,4,2,4,4,2,2,4,2,4,2,2,2,4,4,4,2,4,4,2,2,2,4,2,2,4,2,4,2,4,2,4,2,2,4,4,4,4,1,1,6
3,0,0,4,2,4,2,2,2,4,4,2,4,4,2,4,4,2,2,4,2,4,2,4,4,4,2,4,2,2,4,2,4,2,4,2,2,4,2,2,2,2,2,4,4,4,2,2,4,4,4,2,4,4,4,2,2,2,4,4,2,2,2,4,2,4,4,2,2,4,4,2,2,4,4,2,4,4,4,4,4,4,2,2,2,2,2,4,2,2,2,2,2,4,2,2,2,2,2,4,4,4,2,4,4,4,4,4,4,2,4,4,2,4,4,4,4,2,4,4,4,2,2,4,2,4,2,2,2,2,2,4,4,4,4,2,2,4,2,4,4,2,4,4,4,4,4,1,1,6
3,0,0,2,4,2,2,4,2,4,4,4,4,4,4,4,2,4,2,4,4,2,4,2,2,2,4,2,4,4,4,2,4,4,4,2,4,4,4,4,4,4,4,2,4,4,4,2,4,2,4,4,2,2,4,2,2,2,2,4,4,4,4,4,2,2,4,2,2,4,2,4,4,4,4,2,4,4,4,4,4,2,2,4,2,4,2,4,2,2,4,4,2,2,2,4,2,4,4,2,2,4,4,4,2,4,2,2,2,2,4,4,4,2,2,4,4,2,2,2,2,2,4,4,4,4,2,4,4,4,4,4,4,4,4,2,2,4,4,4,2,2,2,4,2,2,4,1,1,6
3,0,0,2,2,2,2,2,4,2,4,2,4,2,4,2,2,4,2,4,4,2,2,4,4,2,2,2,4,2,4,2,4,4,4,2,4,4,2,4,4,2,2,4,2,4,4,4,2,2,2,4,4,2,2,4,4,4,4,2,2,4,2,4,2,4,2,2,2,2,4,2,4,2,4,4,4,2,4,2,4,4,4,2,4,4,2,2,4,2,2,4,4,2,2,2,4,2,4,4,2,2,2,4,4,4,4,2,2,2,4,2,4,2,2,4,2,4,2,4,4,4,2,4,2,4,4,2,4,2,2,4,2,4,4,2,4,2,2,4,4,4,4,4,4,2,4,1,1,6
3,0,0,4,4,2,4,2,2,2,2,2,4,4,4,2,2,2,4,2,2,4,2,4,2,2,2,2,2,2,4,2,4,2,2,4,4,2,4,2,4,4,4,2,4,2,2,2,4,2,2,2,2,4,2,2,2,2,2,2,4,4,4,4,2,2,4,4,4,2,4,4,4,2,4,4,4,4,4,2,2,2,2,2,2,4,2,4,4,2,4,2,2,2,2,4,4,2,4,4,2,4,4,2,4,2,2,2,2,2,4,4,4,2,2,2,2,4,2,4,4,4,4,2,4,2,4,2,4,4,2,2,4,4,2,2,2,2,4,2,2,2,4,4,4,2,4,1,1,6
3,0,0,4,2,4,2,2,2,2,4,4,2,2,2,4,2,4,4,2,2,4,4,2,2,4,4,2,2,2,4,2,4,4,4,2,4,2,4,2,2,2,2,4,4,2,2,4,4,4,4,2,2,2,4,4,4,2,2,4,4,2,4,2,4,4,4,4,2,4,2,2,2,2,2,2,4,4,4,4,4,2,4,2,4,2,2,2,2,4,2,2,2,2,2,4,2,4,4,4,4,2,2,4,4,4,4,2,4,2,2,4,2,4,2,2,2,2,2,2,2,2,4,4,4,2,4,2,4,2,2,4,2,2,4,4,4,4,4,4,2,2,2,2,2,2,2,1,1,6
3,0,0,2,2,2,4,2,2,4,4,2,4,2,4,4,4,4,2,2,4,4,2,4,4,4,2,4,2,2,4,4,4,2,2,2,2,2,4,2,2,2,4,4,4,2,2,4,4,4,2,4,4,2,4,2,4,4,4,2,4,4,2,2,2,2,2,4,4,4,2,2,4,2,4,2,4,2,2,2,4,2,4,2,4,4,2,4,2,2,2,4,2,4,4,4,4,2,4,4,2,2,4,2,4,4,4,4,2,4,2,2,2,4,4,2,2,2,2,4,2,2,2,2,2,2,2,4,2,2,4,4,4,2,4,4,4,4,2,2,4,2,4,4,4,2,2,1,1,6
3,0,0,2,2,4,4,4,2,4,2,2,2,2,2,4,2,2,2,4,2,4,2,2,4,2,4,4,4,2,2,4,2,4,4,2,2,2,4,2,4,2,4,4,4,4,2,2,2,4,4,4,4,4,4,2,4,4,4,2,4,4,4,4,4,2,2,4,2,4,4,2,2,4,4,2,4,4,2,2,2,4,2,4,4,4,2,4,4,4,4,2,4,2,2,4,2,2,2,2,4,2,2,2,4,4,4,2,2,4,4,4,2,2,4,2,2,2,2,2,2,2,4,2,4,4,2,2,2,4,4,4,4,2,4,2,2,2,2,4,4,2,4,4,2,2,2,1,1,6
3,0,0,4,2,4,2,2,4,2,2,2,4,4,4,2,4,2,2,4,2,2,2,2,4,2,2,4,4,2,2,4,4,4,2,4,2,2,2,2,4,2,4,2,2,2,2,2,2,2,2,4,2,4,2,4,4,2,2,4,2,4,2,2,2,2,2,4,4,4,4,4,4,4,4,2,2,4,4,2,4,2,2,2,4,4,2,4,2,2,4,4,2,2,2,2,4,4,4,2,2,4,4,4,2,2,4,4,4,2,2,2,4,2,2,2,4,2,4,2,2,2,2,2,4,4,4,4,2,2,4,2,2,4,4,2,2,2,2,2,2,4,2,2,2,2,2,1,1,6
3,0,0,4,4,2,4,4,4,2,2,2,2,4,2,2,4,4,4,4,4,2,4,2,4,4,2,2,4,2,4,4,2,4,4,2,2,4,4,2,2,2,4,2,4,4,4,2,4,4,4,4,4,2,4,4,4,4,4,2,2,2,4,4,4,2,4,4,2,2,2,2,4,4,4,4,2,2,2,4,4,4,2,2,2,2,2,2,4,4,4,4,2,4,4,2,2,4,4,2,4,4,2,2,4,4,4,2,4,2,4,4,2,2,2,4,4,2,4,4,2,2,2,4,2,4,4,2,2,2,4,4,4,2,4,4,2,4,2,4,2,2,2,4,4,2,2,1,1,6
3,0,0,4,4,4,2,2,4,4,2,2,2,4,4,4,4,4,2,4,2,2,2,4,2,4,2,2,2,2,4,4,4,2,2,4,4,4,4,4,2,2,2,4,2,4,4,2,4,4,2,4,4,4,4,4,4,4,4,4,4,4,2,4,2,4,4,2,4,4,2,4,2,2,4,4,2,4,2,4,2,2,2,2,2,4,4,4,2,2,4,4,2,4,2,4,2,2,2,2,2,2,2,4,4,4,2,2,4,4,2,4,4,2,2,4,2,4,4,4,2,2,4,4,4,2,4,2,4,4,2,4,4,4,4,4,2,4,4,2,4,4,4,2,2,2,4,1,1,6
3,0,0,4,2,2,4,4,4,2,4,2,4,2,4,4,2,2,4,4,2,4,2,2,2,4,4,2,2,4,2,4,4,2,4,2,4,4,2,2,2,2,2,2,4,2,2,2,2,4,2,2,2,4,2,4,4,2,2,2,4,2,4,4,2,2,2,2,4,4,4,4,4,2,4,2,2,4,4,4,4,2,4,4,4,2,2,2,4,2,4,4,2,4,2,4,4,2,4,4,4,2,2,2,2,2,4,2,4,4,2,2,2,4,2,4,4,4,2,2,4,4,2,2,4,4,2,4,2,2,2,4,2,2,2,2,4,4,2,4,2,2,2,4,4,4,2,1,1,6
3,0,0,2,4,4,2,4,2,2,2,2,2,2,4,2,4,2,2,4,2,4,4,2,2,4,2,2,2,2,4,4,2,4,4,2,2,2,2,2,2,4,2,2,2,2,2,4,2,4,2,2,2,2,4,4,2,4,2,2,4,4,2,2,4,4,4,4,2,2,2,4,2,2,4,2,4,2,4,4,2,4,2,4,4,4,4,4,4,4,2,4,4,2,2,4,4,2,2,2,4,2,2,4,2,2,2,2,2,2,4,2,2,4,4,4,4,2,2,2,2,4,2,2,4,2,2,4,2,4,4,2,2,4,2,4,2,2,2,4,4,2,2,2,2,4,4,1,1,6
3,0,0,2,2,2,4,4,2,2,2,4,2,4,4,4,4,4,4,2,2,2,2,2,2,4,4,2,2,4,4,2,2,2,2,2,2,2,4,2,4,4,4,2,4,2,4,4,4,4,4,4,4,4,2,4,4,2,2,4,2,2,4,2,2,2,4,4,2,2,2,2,2,2,2,2,4,4,2,4,2,4,4,2,4,2,2,2,4,4,2,4,4,4,2,4,4,4,4,2,4,4,4,4,2,2,2,4,2,4,4,2,4,4,4,4,4,2,2,4,2,2,4,2,2,4,2,2,2,4,2,4,2,4,4,4,4,2,2,4,2,2,4,2,2,2,2,1,1,6
3,0,0,4,4,2,2,4,2,2,4,2,2,2,4,2,2,4,2,4,4,2,2,4,4,4,2,4,2,4,2,4,2,2,2,4,2,4,2,4,2,4,2,4,2,2,4,4,4,2,2,2,2,2,4,2,4,2,4,2,2,4,2,2,4,4,4,4,2,2,2,2,2,4,2,2,4,4,2,4,2,2,4,2,4,2,4,2,2,4,4,4,4,4,4,4,2,4,4,4,2,2,2,2,2,4,4,4,4,2,4,4,2,2,2,4,4,2,2,2,4,4,4,4,4,2,2,2,2,4,2,4,4,2,2,4,2,2,2,4,4,4,4,4,2,4,2,1,1,6
3,0,0,2,2,4,4,2,2,4,4,4,2,4,2,4,4,4,4,4,4,4,4,2,4,2,2,4,2,2,4,2,4,4,2,4,2,4,2,2,4,2,2,4,2,2,2,4,4,2,4,4,4,4,2,4,2,4,2,2,2,2,2,2,2,4,2,2,4,2,2,2,4,2,4,4,2,4,4,2,2,4,4,4,4,2,2,4,4,2,2,2,2,4,4,2,4,4,4,2,4,4,2,2,2,2,4,4,4,2,2,2,2,2,4,4,4,4,2,2,4,4,2,4,2,2,4,2,4,4,4,2,2,2,4,2,2,2,4,2,2,4,2,4,2,2,2,1,1,6
3,0,0,0,0,0,0,0,0,0,0,0,0,0,0,0,0,0,0,0,0,0,0,0,0,0,0,0,0,0,0,0,0,0,0,0,0,0,0,0,0,0,0,0,0,0,0,0,0,0,0,0,0,0,0,0,0,0,0,0,0,0,0,0,0,0,0,0,0,0,0,0,0,0,0,0,0,0,0,0,0,0,0,0,0,0,0,0,0,0,0,0,0,0,0,0,0,0,0,0,0,0,0,0,0,0,0,0,0,0,0,0,0,0,0,0,0,0,0,0,0,0,0,0,0,0,0,0,0,0,0,0,0,0,0,0,0,0,0,0,0,0,0,0,0,0,0,0,0,0
3,0,0,0,0,0,0,0,0,0,0,0,0,0,0,0,0,0,0,0,0,0,0,0,0,0,0,0,0,0,0,0,0,0,0,0,0,0,0,0,0,0,0,0,0,0,0,0,0,0,0,0,0,0,0,0,0,0,0,0,0,0,0,0,0,0,0,0,0,0,0,0,0,0,0,0,0,0,0,0,0,0,0,0,0,0,0,0,0,0,0,0,0,0,0,0,0,0,0,0,0,0,0,0,0,0,0,0,0,0,0,0,0,0,0,0,0,0,0,0,0,0,0,0,0,0,0,0,0,0,0,0,0,0,0,0,0,0,0,0,0,0,0,0,0,0,0,0,0,0
3,3,3,3,3,3,3,3,3,3,3,3,3,3,3,3,3,3,3,3,3,3,3,3,3,3,3,3,3,3,3,3,3,3,3,3,3,3,3,3,3,3,3,3,3,3,3,3,3,3,3,3,3,3,3,3,3,3,3,3,3,3,3,3,3,3,3,3,3,3,3,3,3,3,3,3,3,3,3,3,3,3,3,3,3,3,3,3,3,3,3,3,3,3,3,3,3,3,3,3,3,3,3,3,3,3,3,3,3,3,3,3,3,3,3,3,3,3,3,3,3,3,3,3,3,3,3,3,3,3,3,3,3,3,3,3,3,3,3,3,3,3,3,3,3,3,3,3,3,3
